###############################
#.............................#
#.............................#
#.............................#
#.............................#
#.............................#
#.............................#
#.............................#
#.............................#
#.............................#
#.............................#
#.............................#
#.............................#
#.............................#
#.............................#
#.............................#
#.............................#
#.............................#
#..............@.мудрец.......#
###############################